0 0 0 0 0 0 0 0 0
0 0 0 0 0 0 0 0 0
0 0 0 2 2 2 0 0 0
0 0 0 0 0 0 0 0 0
0 0 0 0 1 1 0 0 0
0 0 1 1 1 0 1 1 0
0 0 0 0 0 0 0 0 0
0 0 1 1 1 1 0 0 0
0 0 0 0 0 0 0 0 0 
15
5
5
15
15
10
5
60